Default_House
11 11
1 1 1 1 1 1 1 1 1 1 1
1 1 1 1 1 1 1 1 1 1 1
1 1 1 3 3 1 3 3 1 1 1
1 1 3 1 1 3 1 1 3 1 1
1 1 3 1 1 1 1 1 3 1 1
1 1 1 3 1 1 1 3 1 1 1
1 1 1 1 3 1 3 1 1 1 1
1 1 1 1 1 3 1 1 1 1 1
1 1 1 1 1 1 1 1 1 1 1
1 1 1 1 1 1 1 1 1 1 1
1 1 1 1 1 1 1 1 1 1 1